##---#---#---#---#---#---#---#---##---##
##---#---#---#---#---#---#---#---##---##
##---#---#---#---#---#---#---#---##---##
########################################
##---#---#---#---#---#---#---#---##---##
##---#---#---#---#---#---#---#---##---##
##---#---#---#---#---#---#---#---##---##
########################################
##---#---#---#---#---#---#---#---##---##
##---#---#---#---#-T-#---#---#---##---##
##---#---#---#---#---#---#---#---##---##
########################################
##---#---#---#---#---#---#---#---##---##
##---#---#---#---#---#---#---#---##---##
##---#---#---#---#---#---#---#---##---##
