#-----------------------------------#--#
-----------------------------------#---#
----------------------------------#----#
----------------------------#####------#
------#---------------------#####------#
----------------------------#####------#
----------------------------#####------#
---------------------------------#-----#
----------------------------------#----#
#########--------------------------#---#
----#-#-#---------------------------#--#
----#-#-#----------------------------#-#
----#####-----------------------------##
----#-#-#------------------------------#
T---#-#-#-----------------------------##
