####################------------------T
####################-------------------
---------------------------------------
---------------------------------------
---------------------------------------
---------------------------------------
---------------------------------------
####################-------------------
####################-------------------
#######################################
#######################################
#######################################
#######################################
#######################################
#######################################
