##---#---#---#---#---#---#---#---#---#--
##---#---#---#---#---#---#---#---#---#--
##---#---#---#---#---#---#---#---#---#--
########################################
##--------------------------------------
##---#---#---#---#---#---#---#---#---#--
##--------------------------------------
########################################
##--------------------------------------
##---#---#---#---#---#---#---#---#---#--
##--------------------------------------
########################################
##---#---#---#---#---#---#---#---#---#--
##---#---#---#---#---#---#---#---#---#--
##---#---#---#---#---#---#---#---#---#--