#-----------------------------------#--#
-----------------------------------#---#
----------------------------------#----#
-----------------####-------######-----#
------#----------#----------#####------#
-----------------####-------#####------#
--------------------#-------######-----#
-----------------####------------#-----#
----------------------------------#----#
#########--------####--------------#---#
----#-#-#--------#--#---------------#--#
----#-#-#--------####----------------#-#
----#####--------#--#-----------------##
----#-#-#--------#--#-----------------##
T---#-#-#-----------------------------##
