#-----------------------------------#--#
-----------------------------------#---#
----------------------------------#----#
-----------------#----------######-----#
------#----------#----------#####------#
-----------------#----------#####------#
-----------------#----------######-----#
-----------------####------------#-----#
----------------------------------#----#
#########--------####--------------#---#
----#-#-#--------#------------------#--#
----#-#-#--------####----------------#-#
----#####--------#--------------------##
----#-#-#--------####-----------------##
T---#-#-#-----------------------------##
