########################################
#---#---#---#---#---#---#---#---#---#---
#---#---#---#---#---#---#---#---#---#---
#---#---#---#---#---#---#---#---#---#---
########################################
#---#---#---#---#---#---#---#---#---#---
#---#---#---#---#---#---#---#---#---#---
#---#---#---#---#---#---#---#---#---#---
########################################
#---#---#---#---#---#---#---#---#---#---
#---#---#---#---#---#---#---#---#---#---
#---#---#---#---#---#---#---#---#---#---
########################################
--------------------T-------------------
########################################